R 800 600
NO textures/wood.xpm
SO ./textures/stone.xpm
WE ./textures/metal.xpm
EA ./textures/brick.xpm
S ./textures/sprite.xpm

F 184,113,39
C 51,198,227

1111111111111111
100000000000000111111
 111110000000000000001
   100020000000000111
1111110000000001111
1000000N00000001
1000000000000001
1000000000000001
1000000000000001
1111111111111111